Minefield-All-Around
MaxSteps = 100
NumShells=20
Rows = 13
Cols = 13
#############
# @@@   @@@ #
# @1@   @1@ #
# @@@   @@@ #
#           #
#############
#############
#############
#           #
# @@@   @@@ #
# @2@   @2@ #
# @@@   @@@ #
#############
